"","Edition","As","Men","Women","Total","Var.6","link","year"
"1","1896 Summer Olympics","Australia",1,0,1,"Results","http://www.olympedia.org/countries/AUS","1896"
"2","1900 Summer Olympics","Australia",1,0,1,"Results","http://www.olympedia.org/countries/AUS","1900"
"3","1904 Summer Olympics","Australia",1,0,1,"Results","http://www.olympedia.org/countries/AUS","1904"
"4","1920 Summer Olympics","Australia",12,1,13,"Results","http://www.olympedia.org/countries/AUS","1920"
"5","1924 Summer Olympics","Australia",35,1,36,"Results","http://www.olympedia.org/countries/AUS","1924"
"6","1924 Winter Olympics","Australia",1,0,1,"Results","http://www.olympedia.org/countries/AUS","1924"
"7","1928 Summer Olympics","Australia",14,4,18,"Results","http://www.olympedia.org/countries/AUS","1928"
"8","1932 Summer Olympics","Australia",8,4,12,"Results","http://www.olympedia.org/countries/AUS","1932"
"9","1936 Summer Olympics","Australia",28,4,32,"Results","http://www.olympedia.org/countries/AUS","1936"
"10","1936 Winter Olympics","Australia",1,0,1,"Results","http://www.olympedia.org/countries/AUS","1936"
"11","1948 Summer Olympics","Australia",66,9,75,"Results","http://www.olympedia.org/countries/AUS","1948"
"12","1952 Summer Olympics","Australia",71,10,81,"Results","http://www.olympedia.org/countries/AUS","1952"
"13","1952 Winter Olympics","Australia",7,2,9,"Results","http://www.olympedia.org/countries/AUS","1952"
"14","1956 Summer Olympics","Australia",250,44,294,"Results","http://www.olympedia.org/countries/AUS","1956"
"15","1956 Winter Olympics","Australia",7,1,8,"Results","http://www.olympedia.org/countries/AUS","1956"
"16","1956 Equestrian Olympics","Australia",4,0,4,"Results","http://www.olympedia.org/countries/AUS","1956"
"17","1960 Summer Olympics","Australia",160,29,189,"Results","http://www.olympedia.org/countries/AUS","1960"
"18","1960 Winter Olympics","Australia",26,4,30,"Results","http://www.olympedia.org/countries/AUS","1960"
"19","1964 Summer Olympics","Australia",203,40,243,"Results","http://www.olympedia.org/countries/AUS","1964"
"20","1964 Winter Olympics","Australia",3,2,5,"Results","http://www.olympedia.org/countries/AUS","1964"
"21","1968 Summer Olympics","Australia",104,24,128,"Results","http://www.olympedia.org/countries/AUS","1968"
"22","1968 Winter Olympics","Australia",3,0,3,"Results","http://www.olympedia.org/countries/AUS","1968"
"23","1972 Summer Olympics","Australia",139,29,168,"Results","http://www.olympedia.org/countries/AUS","1972"
"24","1972 Winter Olympics","Australia",4,0,4,"Results","http://www.olympedia.org/countries/AUS","1972"
"25","1976 Summer Olympics","Australia",146,34,180,"Results","http://www.olympedia.org/countries/AUS","1976"
"26","1976 Winter Olympics","Australia",5,3,8,"Results","http://www.olympedia.org/countries/AUS","1976"
"27","1980 Summer Olympics","Australia",92,28,120,"Results","http://www.olympedia.org/countries/AUS","1980"
"28","1980 Winter Olympics","Australia",5,4,9,"Results","http://www.olympedia.org/countries/AUS","1980"
"29","1984 Summer Olympics","Australia",169,73,242,"Results","http://www.olympedia.org/countries/AUS","1984"
"30","1984 Winter Olympics","Australia",8,2,10,"Results","http://www.olympedia.org/countries/AUS","1984"
"31","1988 Summer Olympics","Australia",180,72,252,"Results","http://www.olympedia.org/countries/AUS","1988"
"32","1988 Winter Olympics","Australia",17,2,19,"Results","http://www.olympedia.org/countries/AUS","1988"
"33","1992 Summer Olympics","Australia",187,92,279,"Results","http://www.olympedia.org/countries/AUS","1992"
"34","1992 Winter Olympics","Australia",15,7,22,"Results","http://www.olympedia.org/countries/AUS","1992"
"35","1994 Winter Olympics","Australia",18,7,25,"Results","http://www.olympedia.org/countries/AUS","1994"
"36","1996 Summer Olympics","Australia",250,167,417,"Results","http://www.olympedia.org/countries/AUS","1996"
"37","1998 Winter Olympics","Australia",15,8,23,"Results","http://www.olympedia.org/countries/AUS","1998"
"38","2000 Summer Olympics","Australia",341,276,617,"Results","http://www.olympedia.org/countries/AUS","2000"
"39","2002 Winter Olympics","Australia",13,12,25,"Results","http://www.olympedia.org/countries/AUS","2002"
"40","2004 Summer Olympics","Australia",268,202,470,"Results","http://www.olympedia.org/countries/AUS","2004"
"41","2006 Winter Olympics","Australia",23,17,40,"Results","http://www.olympedia.org/countries/AUS","2006"
"42","2008 Summer Olympics","Australia",233,199,432,"Results","http://www.olympedia.org/countries/AUS","2008"
"43","2010 Winter Olympics","Australia",20,20,40,"Results","http://www.olympedia.org/countries/AUS","2010"
"44","2012 Summer Olympics","Australia",221,184,405,"Results","http://www.olympedia.org/countries/AUS","2012"
"45","2014 Winter Olympics","Australia",29,31,60,"Results","http://www.olympedia.org/countries/AUS","2014"
"46","2016 Summer Olympics","Australia",208,212,420,"Results","http://www.olympedia.org/countries/AUS","2016"
"47","2018 Winter Olympics","Australia",27,22,49,"Results","http://www.olympedia.org/countries/AUS","2018"
"48","2020 Summer Olympics","Australia",222,257,479,"Results","http://www.olympedia.org/countries/AUS","2020"
"49","2022 Winter Olympics","Australia",21,21,42,"Results","http://www.olympedia.org/countries/AUS","2022"
"50","1904 Summer Olympics","Canada",54,0,54,"Results","http://www.olympedia.org/countries/CAN","1904"
"51","1908 Summer Olympics","Canada",87,0,87,"Results","http://www.olympedia.org/countries/CAN","1908"
"52","1912 Summer Olympics","Canada",37,0,37,"Results","http://www.olympedia.org/countries/CAN","1912"
"53","1920 Summer Olympics","Canada",55,0,55,"Results","http://www.olympedia.org/countries/CAN","1920"
"54","1924 Summer Olympics","Canada",65,0,65,"Results","http://www.olympedia.org/countries/CAN","1924"
"55","1924 Winter Olympics","Canada",11,1,12,"Results","http://www.olympedia.org/countries/CAN","1924"
"56","1928 Summer Olympics","Canada",61,7,68,"Results","http://www.olympedia.org/countries/CAN","1928"
"57","1928 Winter Olympics","Canada",20,3,23,"Results","http://www.olympedia.org/countries/CAN","1928"
"58","1932 Summer Olympics","Canada",85,17,102,"Results","http://www.olympedia.org/countries/CAN","1932"
"59","1932 Winter Olympics","Canada",38,4,42,"Results","http://www.olympedia.org/countries/CAN","1932"
"60","1936 Summer Olympics","Canada",79,18,97,"Results","http://www.olympedia.org/countries/CAN","1936"
"61","1936 Winter Olympics","Canada",22,7,29,"Results","http://www.olympedia.org/countries/CAN","1936"
"62","1948 Summer Olympics","Canada",105,22,127,"Results","http://www.olympedia.org/countries/CAN","1948"
"63","1948 Winter Olympics","Canada",24,4,28,"Results","http://www.olympedia.org/countries/CAN","1948"
"64","1952 Summer Olympics","Canada",97,10,107,"Results","http://www.olympedia.org/countries/CAN","1952"
"65","1952 Winter Olympics","Canada",31,8,39,"Results","http://www.olympedia.org/countries/CAN","1952"
"66","1956 Summer Olympics","Canada",77,15,92,"Results","http://www.olympedia.org/countries/CAN","1956"
"67","1956 Winter Olympics","Canada",27,8,35,"Results","http://www.olympedia.org/countries/CAN","1956"
"68","1956 Equestrian Olympics","Canada",4,0,4,"Results","http://www.olympedia.org/countries/CAN","1956"
"69","1960 Summer Olympics","Canada",74,11,85,"Results","http://www.olympedia.org/countries/CAN","1960"
"70","1960 Winter Olympics","Canada",34,10,44,"Results","http://www.olympedia.org/countries/CAN","1960"
"71","1964 Summer Olympics","Canada",95,20,115,"Results","http://www.olympedia.org/countries/CAN","1964"
"72","1964 Winter Olympics","Canada",43,12,55,"Results","http://www.olympedia.org/countries/CAN","1964"
"73","1968 Summer Olympics","Canada",111,28,139,"Results","http://www.olympedia.org/countries/CAN","1968"
"74","1968 Winter Olympics","Canada",55,15,70,"Results","http://www.olympedia.org/countries/CAN","1968"
"75","1972 Summer Olympics","Canada",158,50,208,"Results","http://www.olympedia.org/countries/CAN","1972"
"76","1972 Winter Olympics","Canada",29,18,47,"Results","http://www.olympedia.org/countries/CAN","1972"
"77","1976 Summer Olympics","Canada",261,124,385,"Results","http://www.olympedia.org/countries/CAN","1976"
"78","1976 Winter Olympics","Canada",38,21,59,"Results","http://www.olympedia.org/countries/CAN","1976"
"79","1980 Winter Olympics","Canada",41,18,59,"Results","http://www.olympedia.org/countries/CAN","1980"
"80","1984 Summer Olympics","Canada",257,151,408,"Results","http://www.olympedia.org/countries/CAN","1984"
"81","1984 Winter Olympics","Canada",47,20,67,"Results","http://www.olympedia.org/countries/CAN","1984"
"82","1988 Summer Olympics","Canada",223,105,328,"Results","http://www.olympedia.org/countries/CAN","1988"
"83","1988 Winter Olympics","Canada",82,30,112,"Results","http://www.olympedia.org/countries/CAN","1988"
"84","1992 Summer Olympics","Canada",179,116,295,"Results","http://www.olympedia.org/countries/CAN","1992"
"85","1992 Winter Olympics","Canada",79,29,108,"Results","http://www.olympedia.org/countries/CAN","1992"
"86","1994 Winter Olympics","Canada",66,29,95,"Results","http://www.olympedia.org/countries/CAN","1994"
"87","1996 Summer Olympics","Canada",152,151,303,"Results","http://www.olympedia.org/countries/CAN","1996"
"88","1998 Winter Olympics","Canada",81,63,144,"Results","http://www.olympedia.org/countries/CAN","1998"
"89","2000 Summer Olympics","Canada",150,144,294,"Results","http://www.olympedia.org/countries/CAN","2000"
"90","2002 Winter Olympics","Canada",85,65,150,"Results","http://www.olympedia.org/countries/CAN","2002"
"91","2004 Summer Olympics","Canada",130,132,262,"Results","http://www.olympedia.org/countries/CAN","2004"
"92","2006 Winter Olympics","Canada",108,83,191,"Results","http://www.olympedia.org/countries/CAN","2006"
"93","2008 Summer Olympics","Canada",186,146,332,"Results","http://www.olympedia.org/countries/CAN","2008"
"94","2010 Winter Olympics","Canada",113,88,201,"Results","http://www.olympedia.org/countries/CAN","2010"
"95","2012 Summer Olympics","Canada",119,154,273,"Results","http://www.olympedia.org/countries/CAN","2012"
"96","2014 Winter Olympics","Canada",121,96,217,"Results","http://www.olympedia.org/countries/CAN","2014"
"97","2016 Summer Olympics","Canada",127,183,310,"Results","http://www.olympedia.org/countries/CAN","2016"
"98","2018 Winter Olympics","Canada",119,101,220,"Results","http://www.olympedia.org/countries/CAN","2018"
"99","2020 Summer Olympics","Canada",148,230,378,"Results","http://www.olympedia.org/countries/CAN","2020"
"100","2022 Winter Olympics","Canada",108,103,211,"Results","http://www.olympedia.org/countries/CAN","2022"
"101","1896 Summer Olympics","France",12,0,12,"Results","http://www.olympedia.org/countries/FRA","1896"
"102","1900 Summer Olympics","France",742,15,757,"Results","http://www.olympedia.org/countries/FRA","1900"
"103","1908 Summer Olympics","France",209,0,209,"Results","http://www.olympedia.org/countries/FRA","1908"
"104","1912 Summer Olympics","France",119,1,120,"Results","http://www.olympedia.org/countries/FRA","1912"
"105","1920 Summer Olympics","France",291,8,299,"Results","http://www.olympedia.org/countries/FRA","1920"
"106","1924 Summer Olympics","France",368,32,400,"Results","http://www.olympedia.org/countries/FRA","1924"
"107","1924 Winter Olympics","France",41,2,43,"Results","http://www.olympedia.org/countries/FRA","1924"
"108","1928 Summer Olympics","France",257,37,294,"Results","http://www.olympedia.org/countries/FRA","1928"
"109","1928 Winter Olympics","France",36,2,38,"Results","http://www.olympedia.org/countries/FRA","1928"
"110","1932 Summer Olympics","France",97,6,103,"Results","http://www.olympedia.org/countries/FRA","1932"
"111","1932 Winter Olympics","France",7,1,8,"Results","http://www.olympedia.org/countries/FRA","1932"
"112","1936 Summer Olympics","France",190,11,201,"Results","http://www.olympedia.org/countries/FRA","1936"
"113","1936 Winter Olympics","France",28,0,28,"Results","http://www.olympedia.org/countries/FRA","1936"
"114","1948 Summer Olympics","France",279,37,316,"Results","http://www.olympedia.org/countries/FRA","1948"
"115","1948 Winter Olympics","France",28,8,36,"Results","http://www.olympedia.org/countries/FRA","1948"
"116","1952 Summer Olympics","France",214,31,245,"Results","http://www.olympedia.org/countries/FRA","1952"
"117","1952 Winter Olympics","France",20,6,26,"Results","http://www.olympedia.org/countries/FRA","1952"
"118","1956 Summer Olympics","France",119,18,137,"Results","http://www.olympedia.org/countries/FRA","1956"
"119","1956 Winter Olympics","France",25,7,32,"Results","http://www.olympedia.org/countries/FRA","1956"
"120","1956 Equestrian Olympics","France",8,0,8,"Results","http://www.olympedia.org/countries/FRA","1956"
"121","1960 Summer Olympics","France",210,28,238,"Results","http://www.olympedia.org/countries/FRA","1960"
"122","1960 Winter Olympics","France",18,8,26,"Results","http://www.olympedia.org/countries/FRA","1960"
"123","1964 Summer Olympics","France",118,20,138,"Results","http://www.olympedia.org/countries/FRA","1964"
"124","1964 Winter Olympics","France",15,9,24,"Results","http://www.olympedia.org/countries/FRA","1964"
"125","1968 Summer Olympics","France",169,31,200,"Results","http://www.olympedia.org/countries/FRA","1968"
"126","1968 Winter Olympics","France",64,11,75,"Results","http://www.olympedia.org/countries/FRA","1968"
"127","1972 Summer Olympics","France",197,30,227,"Results","http://www.olympedia.org/countries/FRA","1972"
"128","1972 Winter Olympics","France",33,7,40,"Results","http://www.olympedia.org/countries/FRA","1972"
"129","1976 Summer Olympics","France",177,29,206,"Results","http://www.olympedia.org/countries/FRA","1976"
"130","1976 Winter Olympics","France",29,6,35,"Results","http://www.olympedia.org/countries/FRA","1976"
"131","1980 Summer Olympics","France",98,23,121,"Results","http://www.olympedia.org/countries/FRA","1980"
"132","1980 Winter Olympics","France",16,6,22,"Results","http://www.olympedia.org/countries/FRA","1980"
"133","1984 Summer Olympics","France",189,49,238,"Results","http://www.olympedia.org/countries/FRA","1984"
"134","1984 Winter Olympics","France",22,10,32,"Results","http://www.olympedia.org/countries/FRA","1984"
"135","1988 Summer Olympics","France",192,74,266,"Results","http://www.olympedia.org/countries/FRA","1988"
"136","1988 Winter Olympics","France",53,15,68,"Results","http://www.olympedia.org/countries/FRA","1988"
"137","1992 Summer Olympics","France",241,98,339,"Results","http://www.olympedia.org/countries/FRA","1992"
"138","1992 Winter Olympics","France",79,30,109,"Results","http://www.olympedia.org/countries/FRA","1992"
"139","1994 Winter Olympics","France",68,30,98,"Results","http://www.olympedia.org/countries/FRA","1994"
"140","1996 Summer Olympics","France",197,102,299,"Results","http://www.olympedia.org/countries/FRA","1996"
"141","1998 Winter Olympics","France",75,31,106,"Results","http://www.olympedia.org/countries/FRA","1998"
"142","2000 Summer Olympics","France",211,125,336,"Results","http://www.olympedia.org/countries/FRA","2000"
"143","2002 Winter Olympics","France",87,27,114,"Results","http://www.olympedia.org/countries/FRA","2002"
"144","2004 Summer Olympics","France",195,113,308,"Results","http://www.olympedia.org/countries/FRA","2004"
"145","2006 Winter Olympics","France",50,32,82,"Results","http://www.olympedia.org/countries/FRA","2006"
"146","2008 Summer Olympics","France",188,121,309,"Results","http://www.olympedia.org/countries/FRA","2008"
"147","2010 Winter Olympics","France",67,37,104,"Results","http://www.olympedia.org/countries/FRA","2010"
"148","2012 Summer Olympics","France",182,142,324,"Results","http://www.olympedia.org/countries/FRA","2012"
"149","2014 Winter Olympics","France",68,39,107,"Results","http://www.olympedia.org/countries/FRA","2014"
"150","2016 Summer Olympics","France",225,167,392,"Results","http://www.olympedia.org/countries/FRA","2016"
"151","2018 Winter Olympics","France",59,41,100,"Results","http://www.olympedia.org/countries/FRA","2018"
"152","2020 Summer Olympics","France",212,168,380,"Results","http://www.olympedia.org/countries/FRA","2020"
"153","2022 Winter Olympics","France",47,33,80,"Results","http://www.olympedia.org/countries/FRA","2022"
"154","1896 Summer Olympics","Germany",19,0,19,"Results","http://www.olympedia.org/countries/GER","1896"
"155","1900 Summer Olympics","Germany",76,0,76,"Results","http://www.olympedia.org/countries/GER","1900"
"156","1904 Summer Olympics","Germany",18,0,18,"Results","http://www.olympedia.org/countries/GER","1904"
"157","1908 Summer Olympics","Germany",80,2,82,"Results","http://www.olympedia.org/countries/GER","1908"
"158","1912 Summer Olympics","Germany",180,5,185,"Results","http://www.olympedia.org/countries/GER","1912"
"159","1928 Summer Olympics","Germany",263,35,298,"Results","http://www.olympedia.org/countries/GER","1928"
"160","1928 Winter Olympics","Germany",39,5,44,"Results","http://www.olympedia.org/countries/GER","1928"
"161","1932 Summer Olympics","Germany",137,9,146,"Results","http://www.olympedia.org/countries/GER","1932"
"162","1932 Winter Olympics","Germany",15,0,15,"Results","http://www.olympedia.org/countries/GER","1932"
"163","1936 Summer Olympics","Germany",389,44,433,"Results","http://www.olympedia.org/countries/GER","1936"
"164","1936 Winter Olympics","Germany",48,7,55,"Results","http://www.olympedia.org/countries/GER","1936"
"165","1952 Summer Olympics","Unified Team of Germany",173,32,205,"Results","http://www.olympedia.org/countries/GER","1952"
"166","1952 Winter Olympics","Unified Team of Germany",41,12,53,"Results","http://www.olympedia.org/countries/GER","1952"
"167","1956 Summer Olympics","Unified Team of Germany",134,24,158,"Results","http://www.olympedia.org/countries/GER","1956"
"168","1956 Winter Olympics","Unified Team of Germany",52,11,63,"Results","http://www.olympedia.org/countries/GER","1956"
"169","1956 Equestrian Olympics","Unified Team of Germany",6,3,9,"Results","http://www.olympedia.org/countries/GER","1956"
"170","1960 Summer Olympics","Unified Team of Germany",239,55,294,"Results","http://www.olympedia.org/countries/GER","1960"
"171","1960 Winter Olympics","Unified Team of Germany",56,18,74,"Results","http://www.olympedia.org/countries/GER","1960"
"172","1964 Summer Olympics","Unified Team of Germany",275,62,337,"Results","http://www.olympedia.org/countries/GER","1964"
"173","1964 Winter Olympics","Unified Team of Germany",73,23,96,"Results","http://www.olympedia.org/countries/GER","1964"
"174","1992 Summer Olympics","Germany",300,163,463,"Results","http://www.olympedia.org/countries/GER","1992"
"175","1992 Winter Olympics","Germany",75,36,111,"Results","http://www.olympedia.org/countries/GER","1992"
"176","1994 Winter Olympics","Germany",79,33,112,"Results","http://www.olympedia.org/countries/GER","1994"
"177","1996 Summer Olympics","Germany",279,187,466,"Results","http://www.olympedia.org/countries/GER","1996"
"178","1998 Winter Olympics","Germany",78,47,125,"Results","http://www.olympedia.org/countries/GER","1998"
"179","2000 Summer Olympics","Germany",241,181,422,"Results","http://www.olympedia.org/countries/GER","2000"
"180","2002 Winter Olympics","Germany",88,69,157,"Results","http://www.olympedia.org/countries/GER","2002"
"181","2004 Summer Olympics","Germany",250,191,441,"Results","http://www.olympedia.org/countries/GER","2004"
"182","2006 Winter Olympics","Germany",94,61,155,"Results","http://www.olympedia.org/countries/GER","2006"
"183","2008 Summer Olympics","Germany",237,183,420,"Results","http://www.olympedia.org/countries/GER","2008"
"184","2010 Winter Olympics","Germany",93,56,149,"Results","http://www.olympedia.org/countries/GER","2010"
"185","2012 Summer Olympics","Germany",212,171,383,"Results","http://www.olympedia.org/countries/GER","2012"
"186","2014 Winter Olympics","Germany",76,75,151,"Results","http://www.olympedia.org/countries/GER","2014"
"187","2016 Summer Olympics","Germany",224,194,418,"Results","http://www.olympedia.org/countries/GER","2016"
"188","2018 Winter Olympics","Germany",89,56,145,"Results","http://www.olympedia.org/countries/GER","2018"
"189","2020 Summer Olympics","Germany",234,158,392,"Results","http://www.olympedia.org/countries/GER","2020"
"190","2022 Winter Olympics","Germany",94,48,142,"Results","http://www.olympedia.org/countries/GER","2022"
"191","1896 Summer Olympics","Great Britain",10,0,10,"Results","http://www.olympedia.org/countries/GBR","1896"
"192","1900 Summer Olympics","Great Britain",95,1,96,"Results","http://www.olympedia.org/countries/GBR","1900"
"193","1904 Summer Olympics","Great Britain",4,0,4,"Results","http://www.olympedia.org/countries/GBR","1904"
"194","1908 Summer Olympics","Great Britain",698,39,737,"Results","http://www.olympedia.org/countries/GBR","1908"
"195","1912 Summer Olympics","Great Britain",263,11,274,"Results","http://www.olympedia.org/countries/GBR","1912"
"196","1920 Summer Olympics","Great Britain",219,16,235,"Results","http://www.olympedia.org/countries/GBR","1920"
"197","1924 Summer Olympics","Great Britain",239,28,267,"Results","http://www.olympedia.org/countries/GBR","1924"
"198","1924 Winter Olympics","Great Britain",41,3,44,"Results","http://www.olympedia.org/countries/GBR","1924"
"199","1928 Summer Olympics","Great Britain",201,31,232,"Results","http://www.olympedia.org/countries/GBR","1928"
"200","1928 Winter Olympics","Great Britain",29,3,32,"Results","http://www.olympedia.org/countries/GBR","1928"
"201","1932 Summer Olympics","Great Britain",92,17,109,"Results","http://www.olympedia.org/countries/GBR","1932"
"202","1932 Winter Olympics","Great Britain",0,4,4,"Results","http://www.olympedia.org/countries/GBR","1932"
"203","1936 Summer Olympics","Great Britain",171,37,208,"Results","http://www.olympedia.org/countries/GBR","1936"
"204","1936 Winter Olympics","Great Britain",29,10,39,"Results","http://www.olympedia.org/countries/GBR","1936"
"205","1948 Summer Olympics","Great Britain",337,70,407,"Results","http://www.olympedia.org/countries/GBR","1948"
"206","1948 Winter Olympics","Great Britain",43,12,55,"Results","http://www.olympedia.org/countries/GBR","1948"
"207","1952 Summer Olympics","Great Britain",213,44,257,"Results","http://www.olympedia.org/countries/GBR","1952"
"208","1952 Winter Olympics","Great Britain",8,10,18,"Results","http://www.olympedia.org/countries/GBR","1952"
"209","1956 Summer Olympics","Great Britain",163,26,189,"Results","http://www.olympedia.org/countries/GBR","1956"
"210","1956 Winter Olympics","Great Britain",31,10,41,"Results","http://www.olympedia.org/countries/GBR","1956"
"211","1956 Equestrian Olympics","Great Britain",5,3,8,"Results","http://www.olympedia.org/countries/GBR","1956"
"212","1960 Summer Olympics","Great Britain",206,47,253,"Results","http://www.olympedia.org/countries/GBR","1960"
"213","1960 Winter Olympics","Great Britain",11,6,17,"Results","http://www.olympedia.org/countries/GBR","1960"
"214","1964 Summer Olympics","Great Britain",160,44,204,"Results","http://www.olympedia.org/countries/GBR","1964"
"215","1964 Winter Olympics","Great Britain",27,9,36,"Results","http://www.olympedia.org/countries/GBR","1964"
"216","1968 Summer Olympics","Great Britain",175,50,225,"Results","http://www.olympedia.org/countries/GBR","1968"
"217","1968 Winter Olympics","Great Britain",28,10,38,"Results","http://www.olympedia.org/countries/GBR","1968"
"218","1972 Summer Olympics","Great Britain",210,74,284,"Results","http://www.olympedia.org/countries/GBR","1972"
"219","1972 Winter Olympics","Great Britain",30,7,37,"Results","http://www.olympedia.org/countries/GBR","1972"
"220","1976 Summer Olympics","Great Britain",176,66,242,"Results","http://www.olympedia.org/countries/GBR","1976"
"221","1976 Winter Olympics","Great Britain",31,11,42,"Results","http://www.olympedia.org/countries/GBR","1976"
"222","1980 Summer Olympics","Great Britain",149,70,219,"Results","http://www.olympedia.org/countries/GBR","1980"
"223","1980 Winter Olympics","Great Britain",36,12,48,"Results","http://www.olympedia.org/countries/GBR","1980"
"224","1984 Summer Olympics","Great Britain",229,108,337,"Results","http://www.olympedia.org/countries/GBR","1984"
"225","1984 Winter Olympics","Great Britain",37,13,50,"Results","http://www.olympedia.org/countries/GBR","1984"
"226","1988 Summer Olympics","Great Britain",219,126,345,"Results","http://www.olympedia.org/countries/GBR","1988"
"227","1988 Winter Olympics","Great Britain",34,14,48,"Results","http://www.olympedia.org/countries/GBR","1988"
"228","1992 Summer Olympics","Great Britain",229,142,371,"Results","http://www.olympedia.org/countries/GBR","1992"
"229","1992 Winter Olympics","Great Britain",39,10,49,"Results","http://www.olympedia.org/countries/GBR","1992"
"230","1994 Winter Olympics","Great Britain",25,7,32,"Results","http://www.olympedia.org/countries/GBR","1994"
"231","1996 Summer Olympics","Great Britain",184,116,300,"Results","http://www.olympedia.org/countries/GBR","1996"
"232","1998 Winter Olympics","Great Britain",27,7,34,"Results","http://www.olympedia.org/countries/GBR","1998"
"233","2000 Summer Olympics","Great Britain",181,129,310,"Results","http://www.olympedia.org/countries/GBR","2000"
"234","2002 Winter Olympics","Great Britain",31,18,49,"Results","http://www.olympedia.org/countries/GBR","2002"
"235","2004 Summer Olympics","Great Britain",161,103,264,"Results","http://www.olympedia.org/countries/GBR","2004"
"236","2006 Winter Olympics","Great Britain",23,16,39,"Results","http://www.olympedia.org/countries/GBR","2006"
"237","2008 Summer Olympics","Great Britain",163,141,304,"Results","http://www.olympedia.org/countries/GBR","2008"
"238","2010 Winter Olympics","Great Britain",28,24,52,"Results","http://www.olympedia.org/countries/GBR","2010"
"239","2012 Summer Olympics","Great Britain",273,257,530,"Results","http://www.olympedia.org/countries/GBR","2012"
"240","2014 Winter Olympics","Great Britain",32,21,53,"Results","http://www.olympedia.org/countries/GBR","2014"
"241","2016 Summer Olympics","Great Britain",201,159,360,"Results","http://www.olympedia.org/countries/GBR","2016"
"242","2018 Winter Olympics","Great Britain",33,23,56,"Results","http://www.olympedia.org/countries/GBR","2018"
"243","2020 Summer Olympics","Great Britain",178,197,375,"Results","http://www.olympedia.org/countries/GBR","2020"
"244","2022 Winter Olympics","Great Britain",26,21,47,"Results","http://www.olympedia.org/countries/GBR","2022"
"245","1896 Summer Olympics","Hungary",7,0,7,"Results","http://www.olympedia.org/countries/HUN","1896"
"246","1900 Summer Olympics","Hungary",19,0,19,"Results","http://www.olympedia.org/countries/HUN","1900"
"247","1904 Summer Olympics","Hungary",4,0,4,"Results","http://www.olympedia.org/countries/HUN","1904"
"248","1908 Summer Olympics","Hungary",63,0,63,"Results","http://www.olympedia.org/countries/HUN","1908"
"249","1912 Summer Olympics","Hungary",119,0,119,"Results","http://www.olympedia.org/countries/HUN","1912"
"250","1924 Summer Olympics","Hungary",86,3,89,"Results","http://www.olympedia.org/countries/HUN","1924"
"251","1924 Winter Olympics","Hungary",4,0,4,"Results","http://www.olympedia.org/countries/HUN","1924"
"252","1928 Summer Olympics","Hungary",93,16,109,"Results","http://www.olympedia.org/countries/HUN","1928"
"253","1928 Winter Olympics","Hungary",13,0,13,"Results","http://www.olympedia.org/countries/HUN","1928"
"254","1932 Summer Olympics","Hungary",56,2,58,"Results","http://www.olympedia.org/countries/HUN","1932"
"255","1932 Winter Olympics","Hungary",2,2,4,"Results","http://www.olympedia.org/countries/HUN","1932"
"256","1936 Summer Olympics","Hungary",197,19,216,"Results","http://www.olympedia.org/countries/HUN","1936"
"257","1936 Winter Olympics","Hungary",22,3,25,"Results","http://www.olympedia.org/countries/HUN","1936"
"258","1948 Summer Olympics","Hungary",107,21,128,"Results","http://www.olympedia.org/countries/HUN","1948"
"259","1948 Winter Olympics","Hungary",17,5,22,"Results","http://www.olympedia.org/countries/HUN","1948"
"260","1952 Summer Olympics","Hungary",162,27,189,"Results","http://www.olympedia.org/countries/HUN","1952"
"261","1952 Winter Olympics","Hungary",8,4,12,"Results","http://www.olympedia.org/countries/HUN","1952"
"262","1956 Summer Olympics","Hungary",88,20,108,"Results","http://www.olympedia.org/countries/HUN","1956"
"263","1956 Winter Olympics","Hungary",1,1,2,"Results","http://www.olympedia.org/countries/HUN","1956"
"264","1956 Equestrian Olympics","Hungary",3,0,3,"Results","http://www.olympedia.org/countries/HUN","1956"
"265","1960 Summer Olympics","Hungary",153,27,180,"Results","http://www.olympedia.org/countries/HUN","1960"
"266","1960 Winter Olympics","Hungary",2,1,3,"Results","http://www.olympedia.org/countries/HUN","1960"
"267","1964 Summer Olympics","Hungary",150,32,182,"Results","http://www.olympedia.org/countries/HUN","1964"
"268","1964 Winter Olympics","Hungary",22,6,28,"Results","http://www.olympedia.org/countries/HUN","1964"
"269","1968 Summer Olympics","Hungary",135,32,167,"Results","http://www.olympedia.org/countries/HUN","1968"
"270","1968 Winter Olympics","Hungary",8,2,10,"Results","http://www.olympedia.org/countries/HUN","1968"
"271","1972 Summer Olympics","Hungary",187,45,232,"Results","http://www.olympedia.org/countries/HUN","1972"
"272","1972 Winter Olympics","Hungary",0,1,1,"Results","http://www.olympedia.org/countries/HUN","1972"
"273","1976 Summer Olympics","Hungary",124,54,178,"Results","http://www.olympedia.org/countries/HUN","1976"
"274","1976 Winter Olympics","Hungary",2,1,3,"Results","http://www.olympedia.org/countries/HUN","1976"
"275","1980 Summer Olympics","Hungary",182,81,263,"Results","http://www.olympedia.org/countries/HUN","1980"
"276","1980 Winter Olympics","Hungary",1,1,2,"Results","http://www.olympedia.org/countries/HUN","1980"
"277","1984 Winter Olympics","Hungary",7,2,9,"Results","http://www.olympedia.org/countries/HUN","1984"
"278","1988 Summer Olympics","Hungary",152,36,188,"Results","http://www.olympedia.org/countries/HUN","1988"
"279","1988 Winter Olympics","Hungary",3,2,5,"Results","http://www.olympedia.org/countries/HUN","1988"
"280","1992 Summer Olympics","Hungary",159,58,217,"Results","http://www.olympedia.org/countries/HUN","1992"
"281","1992 Winter Olympics","Hungary",13,11,24,"Results","http://www.olympedia.org/countries/HUN","1992"
"282","1994 Winter Olympics","Hungary",5,11,16,"Results","http://www.olympedia.org/countries/HUN","1994"
"283","1996 Summer Olympics","Hungary",147,66,213,"Results","http://www.olympedia.org/countries/HUN","1996"
"284","1998 Winter Olympics","Hungary",8,9,17,"Results","http://www.olympedia.org/countries/HUN","1998"
"285","2000 Summer Olympics","Hungary",109,69,178,"Results","http://www.olympedia.org/countries/HUN","2000"
"286","2002 Winter Olympics","Hungary",14,11,25,"Results","http://www.olympedia.org/countries/HUN","2002"
"287","2004 Summer Olympics","Hungary",119,90,209,"Results","http://www.olympedia.org/countries/HUN","2004"
"288","2006 Winter Olympics","Hungary",11,8,19,"Results","http://www.olympedia.org/countries/HUN","2006"
"289","2008 Summer Olympics","Hungary",88,83,171,"Results","http://www.olympedia.org/countries/HUN","2008"
"290","2010 Winter Olympics","Hungary",6,9,15,"Results","http://www.olympedia.org/countries/HUN","2010"
"291","2012 Summer Olympics","Hungary",93,59,152,"Results","http://www.olympedia.org/countries/HUN","2012"
"292","2014 Winter Olympics","Hungary",7,9,16,"Results","http://www.olympedia.org/countries/HUN","2014"
"293","2016 Summer Olympics","Hungary",88,66,154,"Results","http://www.olympedia.org/countries/HUN","2016"
"294","2018 Winter Olympics","Hungary",8,10,18,"Results","http://www.olympedia.org/countries/HUN","2018"
"295","2020 Summer Olympics","Hungary",81,91,172,"Results","http://www.olympedia.org/countries/HUN","2020"
"296","2022 Winter Olympics","Hungary",6,5,11,"Results","http://www.olympedia.org/countries/HUN","2022"
"297","1896 Summer Olympics","Italy",1,0,1,"Results","http://www.olympedia.org/countries/ITA","1896"
"298","1900 Summer Olympics","Italy",22,1,23,"Results","http://www.olympedia.org/countries/ITA","1900"
"299","1904 Summer Olympics","Italy",1,0,1,"Results","http://www.olympedia.org/countries/ITA","1904"
"300","1908 Summer Olympics","Italy",66,0,66,"Results","http://www.olympedia.org/countries/ITA","1908"
"301","1912 Summer Olympics","Italy",66,0,66,"Results","http://www.olympedia.org/countries/ITA","1912"
"302","1920 Summer Olympics","Italy",173,1,174,"Results","http://www.olympedia.org/countries/ITA","1920"
"303","1924 Summer Olympics","Italy",196,4,200,"Results","http://www.olympedia.org/countries/ITA","1924"
"304","1924 Winter Olympics","Italy",23,0,23,"Results","http://www.olympedia.org/countries/ITA","1924"
"305","1928 Summer Olympics","Italy",156,18,174,"Results","http://www.olympedia.org/countries/ITA","1928"
"306","1928 Winter Olympics","Italy",13,0,13,"Results","http://www.olympedia.org/countries/ITA","1928"
"307","1932 Summer Olympics","Italy",112,0,112,"Results","http://www.olympedia.org/countries/ITA","1932"
"308","1932 Winter Olympics","Italy",12,0,12,"Results","http://www.olympedia.org/countries/ITA","1932"
"309","1936 Summer Olympics","Italy",228,16,244,"Results","http://www.olympedia.org/countries/ITA","1936"
"310","1936 Winter Olympics","Italy",35,5,40,"Results","http://www.olympedia.org/countries/ITA","1936"
"311","1948 Summer Olympics","Italy",195,20,215,"Results","http://www.olympedia.org/countries/ITA","1948"
"312","1948 Winter Olympics","Italy",50,3,53,"Results","http://www.olympedia.org/countries/ITA","1948"
"313","1952 Summer Olympics","Italy",208,23,231,"Results","http://www.olympedia.org/countries/ITA","1952"
"314","1952 Winter Olympics","Italy",28,5,33,"Results","http://www.olympedia.org/countries/ITA","1952"
"315","1956 Summer Olympics","Italy",114,15,129,"Results","http://www.olympedia.org/countries/ITA","1956"
"316","1956 Winter Olympics","Italy",53,12,65,"Results","http://www.olympedia.org/countries/ITA","1956"
"317","1956 Equestrian Olympics","Italy",6,0,6,"Results","http://www.olympedia.org/countries/ITA","1956"
"318","1960 Summer Olympics","Italy",246,34,280,"Results","http://www.olympedia.org/countries/ITA","1960"
"319","1960 Winter Olympics","Italy",21,7,28,"Results","http://www.olympedia.org/countries/ITA","1960"
"320","1964 Summer Olympics","Italy",157,11,168,"Results","http://www.olympedia.org/countries/ITA","1964"
"321","1964 Winter Olympics","Italy",53,8,61,"Results","http://www.olympedia.org/countries/ITA","1964"
"322","1968 Summer Olympics","Italy",152,15,167,"Results","http://www.olympedia.org/countries/ITA","1968"
"323","1968 Winter Olympics","Italy",39,8,47,"Results","http://www.olympedia.org/countries/ITA","1968"
"324","1972 Summer Olympics","Italy",197,27,224,"Results","http://www.olympedia.org/countries/ITA","1972"
"325","1972 Winter Olympics","Italy",41,3,44,"Results","http://www.olympedia.org/countries/ITA","1972"
"326","1976 Summer Olympics","Italy",183,27,210,"Results","http://www.olympedia.org/countries/ITA","1976"
"327","1976 Winter Olympics","Italy",47,11,58,"Results","http://www.olympedia.org/countries/ITA","1976"
"328","1980 Summer Olympics","Italy",121,38,159,"Results","http://www.olympedia.org/countries/ITA","1980"
"329","1980 Winter Olympics","Italy",34,12,46,"Results","http://www.olympedia.org/countries/ITA","1980"
"330","1984 Summer Olympics","Italy",222,46,268,"Results","http://www.olympedia.org/countries/ITA","1984"
"331","1984 Winter Olympics","Italy",59,15,74,"Results","http://www.olympedia.org/countries/ITA","1984"
"332","1988 Summer Olympics","Italy",212,41,253,"Results","http://www.olympedia.org/countries/ITA","1988"
"333","1988 Winter Olympics","Italy",42,16,58,"Results","http://www.olympedia.org/countries/ITA","1988"
"334","1992 Summer Olympics","Italy",228,76,304,"Results","http://www.olympedia.org/countries/ITA","1992"
"335","1992 Winter Olympics","Italy",79,28,107,"Results","http://www.olympedia.org/countries/ITA","1992"
"336","1994 Winter Olympics","Italy",78,26,104,"Results","http://www.olympedia.org/countries/ITA","1994"
"337","1996 Summer Olympics","Italy",236,104,340,"Results","http://www.olympedia.org/countries/ITA","1996"
"338","1998 Winter Olympics","Italy",79,34,113,"Results","http://www.olympedia.org/countries/ITA","1998"
"339","2000 Summer Olympics","Italy",246,115,361,"Results","http://www.olympedia.org/countries/ITA","2000"
"340","2002 Winter Olympics","Italy",63,46,109,"Results","http://www.olympedia.org/countries/ITA","2002"
"341","2004 Summer Olympics","Italy",229,135,364,"Results","http://www.olympedia.org/countries/ITA","2004"
"342","2006 Winter Olympics","Italy",106,73,179,"Results","http://www.olympedia.org/countries/ITA","2006"
"343","2008 Summer Olympics","Italy",203,130,333,"Results","http://www.olympedia.org/countries/ITA","2008"
"344","2010 Winter Olympics","Italy",69,40,109,"Results","http://www.olympedia.org/countries/ITA","2010"
"345","2012 Summer Olympics","Italy",158,123,281,"Results","http://www.olympedia.org/countries/ITA","2012"
"346","2014 Winter Olympics","Italy",67,43,110,"Results","http://www.olympedia.org/countries/ITA","2014"
"347","2016 Summer Olympics","Italy",168,141,309,"Results","http://www.olympedia.org/countries/ITA","2016"
"348","2018 Winter Olympics","Italy",71,45,116,"Results","http://www.olympedia.org/countries/ITA","2018"
"349","2020 Summer Olympics","Italy",188,178,366,"Results","http://www.olympedia.org/countries/ITA","2020"
"350","2022 Winter Olympics","Italy",70,47,117,"Results","http://www.olympedia.org/countries/ITA","2022"
"351","1912 Summer Olympics","Japan",2,0,2,"Results","http://www.olympedia.org/countries/JPN","1912"
"352","1920 Summer Olympics","Japan",15,0,15,"Results","http://www.olympedia.org/countries/JPN","1920"
"353","1924 Summer Olympics","Japan",19,0,19,"Results","http://www.olympedia.org/countries/JPN","1924"
"354","1928 Summer Olympics","Japan",39,1,40,"Results","http://www.olympedia.org/countries/JPN","1928"
"355","1928 Winter Olympics","Japan",6,0,6,"Results","http://www.olympedia.org/countries/JPN","1928"
"356","1932 Summer Olympics","Japan",140,17,157,"Results","http://www.olympedia.org/countries/JPN","1932"
"357","1932 Winter Olympics","Japan",16,0,16,"Results","http://www.olympedia.org/countries/JPN","1932"
"358","1936 Summer Olympics","Japan",204,16,220,"Results","http://www.olympedia.org/countries/JPN","1936"
"359","1936 Winter Olympics","Japan",30,1,31,"Results","http://www.olympedia.org/countries/JPN","1936"
"360","1952 Summer Olympics","Japan",58,11,69,"Results","http://www.olympedia.org/countries/JPN","1952"
"361","1952 Winter Olympics","Japan",13,0,13,"Results","http://www.olympedia.org/countries/JPN","1952"
"362","1956 Summer Olympics","Japan",94,16,110,"Results","http://www.olympedia.org/countries/JPN","1956"
"363","1956 Winter Olympics","Japan",10,0,10,"Results","http://www.olympedia.org/countries/JPN","1956"
"364","1956 Equestrian Olympics","Japan",2,0,2,"Results","http://www.olympedia.org/countries/JPN","1956"
"365","1960 Summer Olympics","Japan",142,20,162,"Results","http://www.olympedia.org/countries/JPN","1960"
"366","1960 Winter Olympics","Japan",36,5,41,"Results","http://www.olympedia.org/countries/JPN","1960"
"367","1964 Summer Olympics","Japan",270,58,328,"Results","http://www.olympedia.org/countries/JPN","1964"
"368","1964 Winter Olympics","Japan",41,6,47,"Results","http://www.olympedia.org/countries/JPN","1964"
"369","1968 Summer Olympics","Japan",146,25,171,"Results","http://www.olympedia.org/countries/JPN","1968"
"370","1968 Winter Olympics","Japan",52,9,61,"Results","http://www.olympedia.org/countries/JPN","1968"
"371","1972 Summer Olympics","Japan",148,36,184,"Results","http://www.olympedia.org/countries/JPN","1972"
"372","1972 Winter Olympics","Japan",64,20,84,"Results","http://www.olympedia.org/countries/JPN","1972"
"373","1976 Summer Olympics","Japan",153,60,213,"Results","http://www.olympedia.org/countries/JPN","1976"
"374","1976 Winter Olympics","Japan",50,8,58,"Results","http://www.olympedia.org/countries/JPN","1976"
"375","1980 Winter Olympics","Japan",46,4,50,"Results","http://www.olympedia.org/countries/JPN","1980"
"376","1984 Summer Olympics","Japan",174,52,226,"Results","http://www.olympedia.org/countries/JPN","1984"
"377","1984 Winter Olympics","Japan",32,7,39,"Results","http://www.olympedia.org/countries/JPN","1984"
"378","1988 Summer Olympics","Japan",186,69,255,"Results","http://www.olympedia.org/countries/JPN","1988"
"379","1988 Winter Olympics","Japan",37,11,48,"Results","http://www.olympedia.org/countries/JPN","1988"
"380","1992 Summer Olympics","Japan",175,81,256,"Results","http://www.olympedia.org/countries/JPN","1992"
"381","1992 Winter Olympics","Japan",40,20,60,"Results","http://www.olympedia.org/countries/JPN","1992"
"382","1994 Winter Olympics","Japan",43,16,59,"Results","http://www.olympedia.org/countries/JPN","1994"
"383","1996 Summer Olympics","Japan",157,149,306,"Results","http://www.olympedia.org/countries/JPN","1996"
"384","1998 Winter Olympics","Japan",92,64,156,"Results","http://www.olympedia.org/countries/JPN","1998"
"385","2000 Summer Olympics","Japan",156,110,266,"Results","http://www.olympedia.org/countries/JPN","2000"
"386","2002 Winter Olympics","Japan",59,44,103,"Results","http://www.olympedia.org/countries/JPN","2002"
"387","2004 Summer Olympics","Japan",139,167,306,"Results","http://www.olympedia.org/countries/JPN","2004"
"388","2006 Winter Olympics","Japan",58,52,110,"Results","http://www.olympedia.org/countries/JPN","2006"
"389","2008 Summer Olympics","Japan",167,165,332,"Results","http://www.olympedia.org/countries/JPN","2008"
"390","2010 Winter Olympics","Japan",48,43,91,"Results","http://www.olympedia.org/countries/JPN","2010"
"391","2012 Summer Olympics","Japan",136,155,291,"Results","http://www.olympedia.org/countries/JPN","2012"
"392","2014 Winter Olympics","Japan",48,62,110,"Results","http://www.olympedia.org/countries/JPN","2014"
"393","2016 Summer Olympics","Japan",171,164,335,"Results","http://www.olympedia.org/countries/JPN","2016"
"394","2018 Winter Olympics","Japan",49,70,119,"Results","http://www.olympedia.org/countries/JPN","2018"
"395","2020 Summer Olympics","Japan",314,286,600,"Results","http://www.olympedia.org/countries/JPN","2020"
"396","2022 Winter Olympics","Japan",48,69,117,"Results","http://www.olympedia.org/countries/JPN","2022"
"397","1900 Summer Olympics","Norway",7,0,7,"Results","http://www.olympedia.org/countries/NOR","1900"
"398","1908 Summer Olympics","Norway",69,0,69,"Results","http://www.olympedia.org/countries/NOR","1908"
"399","1912 Summer Olympics","Norway",188,2,190,"Results","http://www.olympedia.org/countries/NOR","1912"
"400","1920 Summer Olympics","Norway",188,6,194,"Results","http://www.olympedia.org/countries/NOR","1920"
"401","1924 Summer Olympics","Norway",60,2,62,"Results","http://www.olympedia.org/countries/NOR","1924"
"402","1924 Winter Olympics","Norway",13,1,14,"Results","http://www.olympedia.org/countries/NOR","1924"
"403","1928 Summer Olympics","Norway",52,0,52,"Results","http://www.olympedia.org/countries/NOR","1928"
"404","1928 Winter Olympics","Norway",22,3,25,"Results","http://www.olympedia.org/countries/NOR","1928"
"405","1932 Summer Olympics","Norway",6,1,7,"Results","http://www.olympedia.org/countries/NOR","1932"
"406","1932 Winter Olympics","Norway",18,1,19,"Results","http://www.olympedia.org/countries/NOR","1932"
"407","1936 Summer Olympics","Norway",68,2,70,"Results","http://www.olympedia.org/countries/NOR","1936"
"408","1936 Winter Olympics","Norway",25,6,31,"Results","http://www.olympedia.org/countries/NOR","1936"
"409","1948 Summer Olympics","Norway",77,4,81,"Results","http://www.olympedia.org/countries/NOR","1948"
"410","1948 Winter Olympics","Norway",45,4,49,"Results","http://www.olympedia.org/countries/NOR","1948"
"411","1952 Summer Olympics","Norway",96,6,102,"Results","http://www.olympedia.org/countries/NOR","1952"
"412","1952 Winter Olympics","Norway",61,12,73,"Results","http://www.olympedia.org/countries/NOR","1952"
"413","1956 Summer Olympics","Norway",18,0,18,"Results","http://www.olympedia.org/countries/NOR","1956"
"414","1956 Winter Olympics","Norway",37,8,45,"Results","http://www.olympedia.org/countries/NOR","1956"
"415","1956 Equestrian Olympics","Norway",1,3,4,"Results","http://www.olympedia.org/countries/NOR","1956"
"416","1960 Summer Olympics","Norway",39,1,40,"Results","http://www.olympedia.org/countries/NOR","1960"
"417","1960 Winter Olympics","Norway",25,4,29,"Results","http://www.olympedia.org/countries/NOR","1960"
"418","1964 Summer Olympics","Norway",24,2,26,"Results","http://www.olympedia.org/countries/NOR","1964"
"419","1964 Winter Olympics","Norway",51,7,58,"Results","http://www.olympedia.org/countries/NOR","1964"
"420","1968 Summer Olympics","Norway",38,8,46,"Results","http://www.olympedia.org/countries/NOR","1968"
"421","1968 Winter Olympics","Norway",54,11,65,"Results","http://www.olympedia.org/countries/NOR","1968"
"422","1972 Summer Olympics","Norway",101,11,112,"Results","http://www.olympedia.org/countries/NOR","1972"
"423","1972 Winter Olympics","Norway",55,11,66,"Results","http://www.olympedia.org/countries/NOR","1972"
"424","1976 Summer Olympics","Norway",60,6,66,"Results","http://www.olympedia.org/countries/NOR","1976"
"425","1976 Winter Olympics","Norway",35,7,42,"Results","http://www.olympedia.org/countries/NOR","1976"
"426","1980 Winter Olympics","Norway",55,9,64,"Results","http://www.olympedia.org/countries/NOR","1980"
"427","1984 Summer Olympics","Norway",84,19,103,"Results","http://www.olympedia.org/countries/NOR","1984"
"428","1984 Winter Olympics","Norway",50,8,58,"Results","http://www.olympedia.org/countries/NOR","1984"
"429","1988 Summer Olympics","Norway",44,25,69,"Results","http://www.olympedia.org/countries/NOR","1988"
"430","1988 Winter Olympics","Norway",53,10,63,"Results","http://www.olympedia.org/countries/NOR","1988"
"431","1992 Summer Olympics","Norway",51,32,83,"Results","http://www.olympedia.org/countries/NOR","1992"
"432","1992 Winter Olympics","Norway",61,19,80,"Results","http://www.olympedia.org/countries/NOR","1992"
"433","1994 Winter Olympics","Norway",67,21,88,"Results","http://www.olympedia.org/countries/NOR","1994"
"434","1996 Summer Olympics","Norway",42,55,97,"Results","http://www.olympedia.org/countries/NOR","1996"
"435","1998 Winter Olympics","Norway",49,27,76,"Results","http://www.olympedia.org/countries/NOR","1998"
"436","2000 Summer Olympics","Norway",44,49,93,"Results","http://www.olympedia.org/countries/NOR","2000"
"437","2002 Winter Olympics","Norway",50,27,77,"Results","http://www.olympedia.org/countries/NOR","2002"
"438","2004 Summer Olympics","Norway",35,17,52,"Results","http://www.olympedia.org/countries/NOR","2004"
"439","2006 Winter Olympics","Norway",46,21,67,"Results","http://www.olympedia.org/countries/NOR","2006"
"440","2008 Summer Olympics","Norway",30,54,84,"Results","http://www.olympedia.org/countries/NOR","2008"
"441","2010 Winter Olympics","Norway",70,25,95,"Results","http://www.olympedia.org/countries/NOR","2010"
"442","2012 Summer Olympics","Norway",33,28,61,"Results","http://www.olympedia.org/countries/NOR","2012"
"443","2014 Winter Olympics","Norway",78,32,110,"Results","http://www.olympedia.org/countries/NOR","2014"
"444","2016 Summer Olympics","Norway",29,33,62,"Results","http://www.olympedia.org/countries/NOR","2016"
"445","2018 Winter Olympics","Norway",75,24,99,"Results","http://www.olympedia.org/countries/NOR","2018"
"446","2020 Summer Olympics","Norway",59,34,93,"Results","http://www.olympedia.org/countries/NOR","2020"
"447","2022 Winter Olympics","Norway",50,29,79,"Results","http://www.olympedia.org/countries/NOR","2022"
"448","1932 Summer Olympics","China",1,0,1,"Results","http://www.olympedia.org/countries/CHN","1932"
"449","1936 Summer Olympics","China",52,2,54,"Results","http://www.olympedia.org/countries/CHN","1936"
"450","1948 Summer Olympics","China",30,1,31,"Results","http://www.olympedia.org/countries/CHN","1948"
"451","1952 Summer Olympics","People's Republic of China",1,0,1,"Results","http://www.olympedia.org/countries/CHN","1952"
"452","1980 Winter Olympics","People's Republic of China",13,11,24,"Results","http://www.olympedia.org/countries/CHN","1980"
"453","1984 Summer Olympics","People's Republic of China",132,83,215,"Results","http://www.olympedia.org/countries/CHN","1984"
"454","1984 Winter Olympics","People's Republic of China",21,16,37,"Results","http://www.olympedia.org/countries/CHN","1984"
"455","1988 Summer Olympics","People's Republic of China",149,124,273,"Results","http://www.olympedia.org/countries/CHN","1988"
"456","1988 Winter Olympics","People's Republic of China",6,7,13,"Results","http://www.olympedia.org/countries/CHN","1988"
"457","1992 Summer Olympics","People's Republic of China",117,127,244,"Results","http://www.olympedia.org/countries/CHN","1992"
"458","1992 Winter Olympics","People's Republic of China",12,20,32,"Results","http://www.olympedia.org/countries/CHN","1992"
"459","1994 Winter Olympics","People's Republic of China",7,17,24,"Results","http://www.olympedia.org/countries/CHN","1994"
"460","1996 Summer Olympics","People's Republic of China",111,183,294,"Results","http://www.olympedia.org/countries/CHN","1996"
"461","1998 Winter Olympics","People's Republic of China",15,42,57,"Results","http://www.olympedia.org/countries/CHN","1998"
"462","2000 Summer Olympics","People's Republic of China",91,180,271,"Results","http://www.olympedia.org/countries/CHN","2000"
"463","2002 Winter Olympics","People's Republic of China",21,45,66,"Results","http://www.olympedia.org/countries/CHN","2002"
"464","2004 Summer Olympics","People's Republic of China",136,247,383,"Results","http://www.olympedia.org/countries/CHN","2004"
"465","2006 Winter Olympics","People's Republic of China",35,38,73,"Results","http://www.olympedia.org/countries/CHN","2006"
"466","2008 Summer Olympics","People's Republic of China",310,289,599,"Results","http://www.olympedia.org/countries/CHN","2008"
"467","2010 Winter Olympics","People's Republic of China",30,56,86,"Results","http://www.olympedia.org/countries/CHN","2010"
"468","2012 Summer Olympics","People's Republic of China",160,216,376,"Results","http://www.olympedia.org/countries/CHN","2012"
"469","2014 Winter Olympics","People's Republic of China",26,36,62,"Results","http://www.olympedia.org/countries/CHN","2014"
"470","2016 Summer Olympics","People's Republic of China",151,241,392,"Results","http://www.olympedia.org/countries/CHN","2016"
"471","2018 Winter Olympics","People's Republic of China",34,45,79,"Results","http://www.olympedia.org/countries/CHN","2018"
"472","2020 Summer Olympics","People's Republic of China",125,285,410,"Results","http://www.olympedia.org/countries/CHN","2020"
"473","2022 Winter Olympics","People's Republic of China",91,82,173,"Results","http://www.olympedia.org/countries/CHN","2022"
"474","1900 Summer Olympics","Russia",4,0,4,"Results","http://www.olympedia.org/countries/RUS","1900"
"475","1908 Summer Olympics","Russia",6,0,6,"Results","http://www.olympedia.org/countries/RUS","1908"
"476","1912 Summer Olympics","Russia",159,0,159,"Results","http://www.olympedia.org/countries/RUS","1912"
"477","1924 Summer Olympics","Russia",2,1,3,"Results","http://www.olympedia.org/countries/RUS","1924"
"478","1994 Winter Olympics","Russian Federation",75,38,113,"Results","http://www.olympedia.org/countries/RUS","1994"
"479","1996 Summer Olympics","Russian Federation",232,158,390,"Results","http://www.olympedia.org/countries/RUS","1996"
"480","1998 Winter Olympics","Russian Federation",79,43,122,"Results","http://www.olympedia.org/countries/RUS","1998"
"481","2000 Summer Olympics","Russian Federation",241,194,435,"Results","http://www.olympedia.org/countries/RUS","2000"
"482","2002 Winter Olympics","Russian Federation",85,66,151,"Results","http://www.olympedia.org/countries/RUS","2002"
"483","2004 Summer Olympics","Russian Federation",244,202,446,"Results","http://www.olympedia.org/countries/RUS","2004"
"484","2006 Winter Olympics","Russian Federation",100,74,174,"Results","http://www.olympedia.org/countries/RUS","2006"
"485","2008 Summer Olympics","Russian Federation",231,223,454,"Results","http://www.olympedia.org/countries/RUS","2008"
"486","2010 Winter Olympics","Russian Federation",94,81,175,"Results","http://www.olympedia.org/countries/RUS","2010"
"487","2012 Summer Olympics","Russian Federation",203,226,429,"Results","http://www.olympedia.org/countries/RUS","2012"
"488","2014 Winter Olympics","Russian Federation",126,88,214,"Results","http://www.olympedia.org/countries/RUS","2014"
"489","2016 Summer Olympics","Russian Federation",142,142,284,"Results","http://www.olympedia.org/countries/RUS","2016"
"490","1896 Summer Olympics","Sweden",1,0,1,"Results","http://www.olympedia.org/countries/SWE","1896"
"491","1900 Summer Olympics","Sweden",10,0,10,"Results","http://www.olympedia.org/countries/SWE","1900"
"492","1908 Summer Olympics","Sweden",165,3,168,"Results","http://www.olympedia.org/countries/SWE","1908"
"493","1912 Summer Olympics","Sweden",422,23,445,"Results","http://www.olympedia.org/countries/SWE","1912"
"494","1920 Summer Olympics","Sweden",247,13,260,"Results","http://www.olympedia.org/countries/SWE","1920"
"495","1924 Summer Olympics","Sweden",146,13,159,"Results","http://www.olympedia.org/countries/SWE","1924"
"496","1924 Winter Olympics","Sweden",31,0,31,"Results","http://www.olympedia.org/countries/SWE","1924"
"497","1928 Summer Olympics","Sweden",87,13,100,"Results","http://www.olympedia.org/countries/SWE","1928"
"498","1928 Winter Olympics","Sweden",24,0,24,"Results","http://www.olympedia.org/countries/SWE","1928"
"499","1932 Summer Olympics","Sweden",78,3,81,"Results","http://www.olympedia.org/countries/SWE","1932"
"500","1932 Winter Olympics","Sweden",11,1,12,"Results","http://www.olympedia.org/countries/SWE","1932"
"501","1936 Summer Olympics","Sweden",163,8,171,"Results","http://www.olympedia.org/countries/SWE","1936"
"502","1936 Winter Olympics","Sweden",31,1,32,"Results","http://www.olympedia.org/countries/SWE","1936"
"503","1948 Summer Olympics","Sweden",162,19,181,"Results","http://www.olympedia.org/countries/SWE","1948"
"504","1948 Winter Olympics","Sweden",42,1,43,"Results","http://www.olympedia.org/countries/SWE","1948"
"505","1952 Summer Olympics","Sweden",183,23,206,"Results","http://www.olympedia.org/countries/SWE","1952"
"506","1952 Winter Olympics","Sweden",56,9,65,"Results","http://www.olympedia.org/countries/SWE","1952"
"507","1956 Summer Olympics","Sweden",74,14,88,"Results","http://www.olympedia.org/countries/SWE","1956"
"508","1956 Winter Olympics","Sweden",50,8,58,"Results","http://www.olympedia.org/countries/SWE","1956"
"509","1956 Equestrian Olympics","Sweden",9,0,9,"Results","http://www.olympedia.org/countries/SWE","1956"
"510","1960 Summer Olympics","Sweden",115,19,134,"Results","http://www.olympedia.org/countries/SWE","1960"
"511","1960 Winter Olympics","Sweden",41,6,47,"Results","http://www.olympedia.org/countries/SWE","1960"
"512","1964 Summer Olympics","Sweden",76,18,94,"Results","http://www.olympedia.org/countries/SWE","1964"
"513","1964 Winter Olympics","Sweden",49,8,57,"Results","http://www.olympedia.org/countries/SWE","1964"
"514","1968 Summer Olympics","Sweden",86,14,100,"Results","http://www.olympedia.org/countries/SWE","1968"
"515","1968 Winter Olympics","Sweden",59,9,68,"Results","http://www.olympedia.org/countries/SWE","1968"
"516","1972 Summer Olympics","Sweden",104,27,131,"Results","http://www.olympedia.org/countries/SWE","1972"
"517","1972 Winter Olympics","Sweden",49,9,58,"Results","http://www.olympedia.org/countries/SWE","1972"
"518","1976 Summer Olympics","Sweden",99,17,116,"Results","http://www.olympedia.org/countries/SWE","1976"
"519","1976 Winter Olympics","Sweden",30,9,39,"Results","http://www.olympedia.org/countries/SWE","1976"
"520","1980 Summer Olympics","Sweden",122,23,145,"Results","http://www.olympedia.org/countries/SWE","1980"
"521","1980 Winter Olympics","Sweden",49,12,61,"Results","http://www.olympedia.org/countries/SWE","1980"
"522","1984 Summer Olympics","Sweden",131,43,174,"Results","http://www.olympedia.org/countries/SWE","1984"
"523","1984 Winter Olympics","Sweden",51,9,60,"Results","http://www.olympedia.org/countries/SWE","1984"
"524","1988 Summer Olympics","Sweden",147,37,184,"Results","http://www.olympedia.org/countries/SWE","1988"
"525","1988 Winter Olympics","Sweden",54,13,67,"Results","http://www.olympedia.org/countries/SWE","1988"
"526","1992 Summer Olympics","Sweden",143,44,187,"Results","http://www.olympedia.org/countries/SWE","1992"
"527","1992 Winter Olympics","Sweden",56,17,73,"Results","http://www.olympedia.org/countries/SWE","1992"
"528","1994 Winter Olympics","Sweden",64,20,84,"Results","http://www.olympedia.org/countries/SWE","1994"
"529","1996 Summer Olympics","Sweden",111,66,177,"Results","http://www.olympedia.org/countries/SWE","1996"
"530","1998 Winter Olympics","Sweden",53,46,99,"Results","http://www.olympedia.org/countries/SWE","1998"
"531","2000 Summer Olympics","Sweden",98,52,150,"Results","http://www.olympedia.org/countries/SWE","2000"
"532","2002 Winter Olympics","Sweden",56,46,102,"Results","http://www.olympedia.org/countries/SWE","2002"
"533","2004 Summer Olympics","Sweden",62,53,115,"Results","http://www.olympedia.org/countries/SWE","2004"
"534","2006 Winter Olympics","Sweden",63,43,106,"Results","http://www.olympedia.org/countries/SWE","2006"
"535","2008 Summer Olympics","Sweden",50,73,123,"Results","http://www.olympedia.org/countries/SWE","2008"
"536","2010 Winter Olympics","Sweden",57,44,101,"Results","http://www.olympedia.org/countries/SWE","2010"
"537","2012 Summer Olympics","Sweden",55,78,133,"Results","http://www.olympedia.org/countries/SWE","2012"
"538","2014 Winter Olympics","Sweden",56,43,99,"Results","http://www.olympedia.org/countries/SWE","2014"
"539","2016 Summer Olympics","Sweden",64,86,150,"Results","http://www.olympedia.org/countries/SWE","2016"
"540","2018 Winter Olympics","Sweden",58,50,108,"Results","http://www.olympedia.org/countries/SWE","2018"
"541","2020 Summer Olympics","Sweden",55,78,133,"Results","http://www.olympedia.org/countries/SWE","2020"
"542","2022 Winter Olympics","Sweden",58,51,109,"Results","http://www.olympedia.org/countries/SWE","2022"
"543","1896 Summer Olympics","United States",14,0,14,"Results","http://www.olympedia.org/countries/USA","1896"
"544","1900 Summer Olympics","United States",66,4,70,"Results","http://www.olympedia.org/countries/USA","1900"
"545","1904 Summer Olympics","United States",537,6,543,"Results","http://www.olympedia.org/countries/USA","1904"
"546","1908 Summer Olympics","United States",122,0,122,"Results","http://www.olympedia.org/countries/USA","1908"
"547","1912 Summer Olympics","United States",174,0,174,"Results","http://www.olympedia.org/countries/USA","1912"
"548","1920 Summer Olympics","United States",274,14,288,"Results","http://www.olympedia.org/countries/USA","1920"
"549","1924 Summer Olympics","United States",275,24,299,"Results","http://www.olympedia.org/countries/USA","1924"
"550","1924 Winter Olympics","United States",22,2,24,"Results","http://www.olympedia.org/countries/USA","1924"
"551","1928 Summer Olympics","United States",237,44,281,"Results","http://www.olympedia.org/countries/USA","1928"
"552","1928 Winter Olympics","United States",21,3,24,"Results","http://www.olympedia.org/countries/USA","1928"
"553","1932 Summer Olympics","United States",400,74,474,"Results","http://www.olympedia.org/countries/USA","1932"
"554","1932 Winter Olympics","United States",55,6,61,"Results","http://www.olympedia.org/countries/USA","1932"
"555","1936 Summer Olympics","United States",313,46,359,"Results","http://www.olympedia.org/countries/USA","1936"
"556","1936 Winter Olympics","United States",46,9,55,"Results","http://www.olympedia.org/countries/USA","1936"
"557","1948 Summer Olympics","United States",262,38,300,"Results","http://www.olympedia.org/countries/USA","1948"
"558","1948 Winter Olympics","United States",59,10,69,"Results","http://www.olympedia.org/countries/USA","1948"
"559","1952 Summer Olympics","United States",245,41,286,"Results","http://www.olympedia.org/countries/USA","1952"
"560","1952 Winter Olympics","United States",56,10,66,"Results","http://www.olympedia.org/countries/USA","1952"
"561","1956 Summer Olympics","United States",251,46,297,"Results","http://www.olympedia.org/countries/USA","1956"
"562","1956 Winter Olympics","United States",57,10,67,"Results","http://www.olympedia.org/countries/USA","1956"
"563","1956 Equestrian Olympics","United States",7,1,8,"Results","http://www.olympedia.org/countries/USA","1956"
"564","1960 Summer Olympics","United States",241,51,292,"Results","http://www.olympedia.org/countries/USA","1960"
"565","1960 Winter Olympics","United States",61,18,79,"Results","http://www.olympedia.org/countries/USA","1960"
"566","1964 Summer Olympics","United States",267,79,346,"Results","http://www.olympedia.org/countries/USA","1964"
"567","1964 Winter Olympics","United States",71,19,90,"Results","http://www.olympedia.org/countries/USA","1964"
"568","1968 Summer Olympics","United States",274,83,357,"Results","http://www.olympedia.org/countries/USA","1968"
"569","1968 Winter Olympics","United States",75,21,96,"Results","http://www.olympedia.org/countries/USA","1968"
"570","1972 Summer Olympics","United States",316,84,400,"Results","http://www.olympedia.org/countries/USA","1972"
"571","1972 Winter Olympics","United States",76,26,102,"Results","http://www.olympedia.org/countries/USA","1972"
"572","1976 Summer Olympics","United States",278,118,396,"Results","http://www.olympedia.org/countries/USA","1976"
"573","1976 Winter Olympics","United States",76,30,106,"Results","http://www.olympedia.org/countries/USA","1976"
"574","1980 Winter Olympics","United States",76,25,101,"Results","http://www.olympedia.org/countries/USA","1980"
"575","1984 Summer Olympics","United States",339,183,522,"Results","http://www.olympedia.org/countries/USA","1984"
"576","1984 Winter Olympics","United States",77,30,107,"Results","http://www.olympedia.org/countries/USA","1984"
"577","1988 Summer Olympics","United States",332,195,527,"Results","http://www.olympedia.org/countries/USA","1988"
"578","1988 Winter Olympics","United States",86,31,117,"Results","http://www.olympedia.org/countries/USA","1988"
"579","1992 Summer Olympics","United States",355,190,545,"Results","http://www.olympedia.org/countries/USA","1992"
"580","1992 Winter Olympics","United States",97,50,147,"Results","http://www.olympedia.org/countries/USA","1992"
"581","1994 Winter Olympics","United States",95,52,147,"Results","http://www.olympedia.org/countries/USA","1994"
"582","1996 Summer Olympics","United States",375,273,648,"Results","http://www.olympedia.org/countries/USA","1996"
"583","1998 Winter Olympics","United States",105,81,186,"Results","http://www.olympedia.org/countries/USA","1998"
"584","2000 Summer Olympics","United States",333,253,586,"Results","http://www.olympedia.org/countries/USA","2000"
"585","2002 Winter Olympics","United States",115,87,202,"Results","http://www.olympedia.org/countries/USA","2002"
"586","2004 Summer Olympics","United States",279,254,533,"Results","http://www.olympedia.org/countries/USA","2004"
"587","2006 Winter Olympics","United States",117,87,204,"Results","http://www.olympedia.org/countries/USA","2006"
"588","2008 Summer Olympics","United States",306,282,588,"Results","http://www.olympedia.org/countries/USA","2008"
"589","2010 Winter Olympics","United States",120,92,212,"Results","http://www.olympedia.org/countries/USA","2010"
"590","2012 Summer Olympics","United States",262,268,530,"Results","http://www.olympedia.org/countries/USA","2012"
"591","2014 Winter Olympics","United States",122,100,222,"Results","http://www.olympedia.org/countries/USA","2014"
"592","2016 Summer Olympics","United States",264,291,555,"Results","http://www.olympedia.org/countries/USA","2016"
"593","2018 Winter Olympics","United States",127,101,228,"Results","http://www.olympedia.org/countries/USA","2018"
"594","2020 Summer Olympics","United States",285,336,621,"Results","http://www.olympedia.org/countries/USA","2020"
"595","2022 Winter Olympics","United States",116,104,220,"Results","http://www.olympedia.org/countries/USA","2022"
